S.No,LocalBodyName,Post,District,State,Winner,Winning Party,Winner Vote,Opposition Vote,VoteDifference
1,बागमती नगरपालिका,प्रमुख,सर्लाही,2,भरत कुमार थापा,नेपाल कम्युनिष्ट पार्टी (माओवादी केन्द्र),7281,6924,357
2,चापाकोट नगरपालिका,प्रमुख,स्याङ्जा,4,शिव कुमार गिरी,नेपाली काँग्रेस,5989,5547,442
3,भिरकोट नगरपालिका,प्रमुख,स्याङ्जा,4,छाया राम खनाल,नेपाली काँग्रेस,6284,4497,1787
4,बनगाड कुपिण्डे नगरपालिका,प्रमुख,सल्यान,6,गोविन्द कुमार पुन,नेपाल कम्युनिष्ट पार्टी (एकीकृत मार्क्सवादी-लेनिनवादी),5077,5042,35
5,भानु नगरपालिका,प्रमुख,तनहुँ,4,उदय राज गौली,नेपाली काँग्रेस,9538,9411,127
6,तानसेन नगरपालिका,प्रमुख,पाल्पा,5,अशोक कुमार शाही,नेपाल कम्युनिष्ट पार्टी (एकीकृत मार्क्सवादी-लेनिनवादी),10450,9552,898
7,मध्यपुर थिमी नगरपालिका,प्रमुख,भक्तपुर,3,मदन सुन्दर (जगुलु) श्रेष्‍ठ,नेपाल कम्युनिष्ट पार्टी (एकीकृत मार्क्सवादी-लेनिनवादी),14000,12760,1240
8,भिमाद नगरपालिका,प्रमुख,तनहुँ,4,मेख बहादुर थापा,नेपाल कम्युनिष्ट पार्टी (एकीकृत मार्क्सवादी-लेनिनवादी),6464,6318,146
9,त्रिवेणी नगरपालिका,प्रमुख,बाजुरा,7,रामसिंह रावल,नेपाली काँग्रेस,3365,3144,221
10,लालिगुँरास नगरपालिका,प्रमुख,तेर्हथुम,1,अर्जुन मावोहाङ,नेपाली काँग्रेस,3851,3682,169
11,इलाम नगरपालिका,प्रमुख,इलाम,1,महेश बस्नेत,नेपाल कम्युनिष्ट पार्टी (एकीकृत मार्क्सवादी-लेनिनवादी),11033,10660,373
12,धर्मदेवी नगरपालिका,प्रमुख,संखुवासभा,1,रमेश कुमार जिमी,नेपाली काँग्रेस,3929,3629,300
13,अर्जुनधारा नगरपालिका,प्रमुख,झापा,1,हरि कुमार राना मगर,नेपाल कम्युनिष्ट पार्टी (एकीकृत मार्क्सवादी-लेनिनवादी),13879,13637,242
14,उर्लावारी नगरपालिका,प्रमुख,मोरङ्ग,1,खड्ग बहादुर फागु,नेपाली काँग्रेस,11632,10968,664
15,पाख्रिवास नगरपालिका,प्रमुख,धनकुटा,1,वृष वहादुर राई,नेपाल कम्युनिष्ट पार्टी (एकीकृत मार्क्सवादी-लेनिनवादी),4439,4298,141
16,रामपुर नगरपालिका,प्रमुख,पाल्पा,5,रमण वहादुर थापा,नेपाली काँग्रेस,8885,7853,1032
17,रोल्पा नगरपालिका,प्रमुख,रोल्पा,5,पुर्ण के‍.सी.,नेपाल कम्युनिष्ट पार्टी (माओवादी केन्द्र),5634,4381,1253
18,पोखरा लेखनाथ महानगरपालिका,प्रमुख,कास्की,4,मान बहादुर जी.सी,नेपाल कम्युनिष्ट पार्टी (एकीकृत मार्क्सवादी-लेनिनवादी),60118,53125,6993
19,मंगलसेन नगरपालिका,प्रमुख,अछाम,7,पदम बहादुर बोहरा,नेपाल कम्युनिष्ट पार्टी (एकीकृत मार्क्सवादी-लेनिनवादी),4691,4556,135
20,निलकण्ठ नगरपालिका,प्रमुख,धादिङ्ग,3,भीम प्रसाद ढुङ्गाना,नेपाली काँग्रेस,13166,7437,5729
21,बुटवल उपमहानगरपालिका,प्रमुख,रुपन्देही,5,शिव राज सुवेदी,नेपाल कम्युनिष्ट पार्टी (एकीकृत मार्क्सवादी-लेनिनवादी),23249,22712,537
22,परोहा नगरपालिका,प्रमुख,रौतहट,2,शेख वकिल,नेपाली काँग्रेस,6330,5791,539
23,म्याङलुङ नगरपालिका,प्रमुख,तेर्हथुम,1,सञ्जय कुमार तुम्वाहाङफे,नेपाल कम्युनिष्ट पार्टी (एकीकृत मार्क्सवादी-लेनिनवादी),3890,3875,15
24,सितगंगा नगरपालिका,प्रमुख,अर्घाखांची,5,सुर्य प्रसाद अधिकारी,नेपाली काँग्रेस,8677,7273,1404
25,धुलिखेल नगरपालिका,प्रमुख,काभ्रेपलाञ्चोक,3,अशोक कुमार ब्याञ्जु श्रेष्ठ,नेपाल कम्युनिष्ट पार्टी (एकीकृत मार्क्सवादी-लेनिनवादी),7981,7614,367
26,ठूली भेरी नगरपालिका,प्रमुख,डोल्पा,6,गणेश बहादुर शाही,नेपाल कम्युनिष्ट पार्टी (एकीकृत मार्क्सवादी-लेनिनवादी),1483,1373,110
27,गौर नगरपालिका,प्रमुख,रौतहट,2,अजय कुमार गुप्‍ता,राष्ट्रिय जनता पार्टी नेपाल,5223,5089,134
28,पनौती नगरपालिका,प्रमुख,काभ्रेपलाञ्चोक,3,भिम न्यौपाने,नेपाल कम्युनिष्ट पार्टी (एकीकृत मार्क्सवादी-लेनिनवादी),12257,11450,807
29,भिमेश्वर  नगरपालिका,प्रमुख,दोलखा,3,भरत वहादुर के.सी.,नेपाल कम्युनिष्ट पार्टी (एकीकृत मार्क्सवादी-लेनिनवादी),6853,6559,294
30,राप्ती नगरपालिका,प्रमुख,चितवन,3,प्रभा बराल,नेपाल कम्युनिष्ट पार्टी (एकीकृत मार्क्सवादी-लेनिनवादी),11613,10316,1297
31,शुक्लागण्डकी नगरपालिका,प्रमुख,तनहुँ,4,किसान गुरुङ्ग,नेपाली काँग्रेस,9424,9205,219
32,बागलुङ नगरपालिका,प्रमुख,बागलुङ,4,जनक राज पौडेल,नेपाल कम्युनिष्ट पार्टी (एकीकृत मार्क्सवादी-लेनिनवादी),12361,10302,2059
33,वालिङ नगरपालिका,प्रमुख,स्याङ्जा,4,दिलिप प्रताप खाँण,नेपाली काँग्रेस,10600,10381,219
34,बुढीगंगा नगरपालिका,प्रमुख,बाजुरा,7,दिपक विक्रम शाह,नेपाली काँग्रेस,3845,3814,31
35,गल्याङ नगरपालिका,प्रमुख,स्याङ्जा,4,भुपराज अधिकारी,नेपाल कम्युनिष्ट पार्टी (एकीकृत मार्क्सवादी-लेनिनवादी),8368,7518,850
36,मध्यनेपाल नगरपालिका,प्रमुख,लमजुंग,4,रमेश कुमार पाण्डे,नेपाली काँग्रेस,5968,4689,1279
37,भक्तपुर नगरपालिका,प्रमुख,भक्तपुर,3,सुनिल प्रजापति,नेपाल मजदुर किसान पार्टी ,25730,14626,11104
38,व्यास नगरपालिका,प्रमुख,तनहुँ,4,बैकुण्ठ नाथ न्यौपाने,नेपाली काँग्रेस,13056,10153,2903
39,थाहा नगरपालिका,प्रमुख,मकवानपुर,3,लवशेर विष्ट,नेपाल कम्युनिष्ट पार्टी (माओवादी केन्द्र),9091,7641,1450
40,छायाँनाथ रारा नगरपालिका,प्रमुख,मुगु,6,हरिजङ्ग शाही,नेपाली काँग्रेस,3560,3557,3
41,सन्धिखर्क नगरपालिका,प्रमुख,अर्घाखांची,5,कमल प्रसाद भुसाल,नेपाली काँग्रेस,8230,7959,271
42,निजगढ नगरपालिका,प्रमुख,बारा,2,सुरेश कुमार खनाल,नेपाली काँग्रेस,7648,7206,442
43,गुर्भाकोट नगरपालिका,प्रमुख,सुर्खेत,6,हस्त पुन,नेपाली काँग्रेस,10063,8885,1178
44,बेसीशहर नगरपालिका,प्रमुख,लमजुंग,4,गुमान सिंह अर्याल,नेपाल कम्युनिष्ट पार्टी (एकीकृत मार्क्सवादी-लेनिनवादी),7624,7386,238
45,महाकाली नगरपालिका,प्रमुख,दार्चुला,7,हंस राज भट्ट,नेपाली काँग्रेस,4043,3882,161
